 1  1  1  1  1  1  1  1  1  1  1  1 
 3  3  3  3  3 -1  2  2  2  2  2  2 
 3 -1  6  6  3  3  2  4  4  4  4  4 
 3  6  6  6 -1  3  2  4  5  5  5  5 
 3  6 -1  6  6  3  2  4  5  5  5  5 
 3  6  7  7  6  3  2  4  4  4  4  4 
 3  6  7  7  6  3  2 -1 -1 -1 -2 -2 
 3  6  7  7  6  3  2 11 11  8  8  8 
 3  6  7  7  6  3  2 11 11  8  9  9 
 3  6  7  7  6  3  2 11 11  8  9 10 
